...X....X....X..
P..X............
...X.......XXX..
...X....X....X..
...XXXXXX....XXX
................
...........XX...
...E.......X....
...........X....
XXXX............
................
.......X.......W
.......X........
.......X........