...X....X....X..
P..X............
...X....X..XXX..
...X....X....X..
...XXXXXX....XXX
................
.......XXXXX....
.......XW..X....
.......X...X....
XXXX...X...X....
.......X........
..E....X........
.......X........
.......X........